ls	ls
chat	chat
national	national
王到	拣到
aha	aha
中共革命	闹革命
iph	iphone
nation	nation
natia	nativ
abdcd	abdc
sver	sver
histor	istor
genreic	genseric
history	history
k	kA
laji	lagi
中国	中国
douyu	doubt
中国人民银行	中国人民银行
hexx	hexa
hello	hello
heoo	hcoo
xxxx	xxx
王道	王道
ixxx	iphonexx
网达	亨达
排	排
